*************************
*         *    *E       *
*    *    *  *********  *
*    *    *    *        *
*    *    *    *  *******
*    *    *    *        *
*S   *         *******  *
************  **     *  *
**             *  *  *  *
*              *  *  *  *
*    ***********  *  *  *
*                 *     *
************************* 